0000000000
1010101000
0000000000
2200220022
0000000000
3030444400
3030000000
3030000000
0000000000
0000000000